1111111111
10CC011001
1010001101
1C100P1011
1010001001
1001000001
11C1C100E1
11111