1111111111
10C0000001
1000000C01
10000P0001
1000000001
10000000E1
1000C00001
1111111111