1111111111
10CC011001
1010001101
1C00P01011
1010001001
1001000001
11C1C100E1
1111111111