1111111111
10CC0110C1
1010001E01
1C00P01011
1010001001
1001000C01
11C1010001
1111111111