1111111111
10CC011001
1010001E01
1C00P01011
1010U01001
1001000C01
11C1010M01
1111111111